1111111111111
10000000P0001
1010000000001
1E10000000001
1C10000000001
1111111111111