11111111111111111111111111111111111111111111111111111111111
10000000000000000000000000000000000000000000000000000011111
10000000000000000000000000000000000000000000000000000011111
10000000000000000000000000000000000000000000000000000011111
10000000000000000000000000000000000000000000000000000011111
10000000000000000000000000000000000000000000000000000011111
10000000000000000000000000000000000000000000000000000011111
10000000000000000000000000000000000000000000000000000011111
10000000000000000000000000000000000000000000000000000011111
10000000000000000000000000000000000000000000000000000011111
10000000000000000000000000000000000000000000000000000011111
1000000000000000000000000000000P000000000000000000000011111
10000000000000000000000000000000000000000000000000000011111
10000000000000000000000000000000000000000000000000000011111
1000000000000000000E00CCC0000000000000000000000000000011111
10000000000000000000000000000000000000000000000000000011111
10000000000000000000000000000000000000000000000000000011111
10000000000000000000000000000000000000000000000000000011111
10000000000000000000000000000000000000000000000000000011111
10000000000000000000000000000000000000000000000000000011111
10000000000000000000000000000000000000000000000000000011111
10000000000000000000000000000000000000000000000000000011111
10000000000000000000000000000000000000000000000000000011111
10000000000000000000000000000000000000000000000000000011111
10000000000000000000000000000000000000000000000000000011111
10000000000000000000000000000000000000000000000000000011111
10000000000000000000000000000000000000000000000000000011111
10000000000000000000000000000000000000000000000000000011111
11111111111111111111111111111111111111111111111111111111111
11111111111111111111111111111111111111111111111111111111111
11111111111111111111111111111111111111111111111111111111111
